Data,Visualizações da página Visão geral (computadores),Visualizações da página Visão geral (dispositivos móveis),Visualizações da página Visão geral (total),Visitantes únicos da página Visão geral (computadores),Visitantes únicos da página Visão geral (dispositivos móveis),Visitantes únicos da página Visão geral (total),Visualizações da página Dia a dia (computadores),Visualizações da página Dia a dia (dispositivos móveis),Visualizações da página Dia a dia (total),Visitantes únicos da página Dia a dia (computadores),Visitantes únicos da página Dia a dia (dispositivos móveis),Visitantes únicos da página Dia a dia (total),Visualizações da página Vagas (computadores),Visualizações da página Vagas (dispositivos móveis),Visualizações da página Vagas (total),Visitantes únicos da página Vagas (computadores),Visitantes únicos da página Vagas (dispositivos móveis),Visitantes únicos da página Vagas (total),Total de visualizações da página (computadores),Total de visualizações da página (dispositivos móveis),Total de visualizações da página (total),Total de visitantes únicos (computadores),Total de visitantes únicos (dispositivos móveis),Total de visitantes únicos (total)
01/17/2023,105,0,105,67,0,67,0,0,0,0,0,0,25,21,46,24,18,42,144,21,165,67,18,85
01/18/2023,201,279,480,106,104,208,0,0,0,0,0,0,46,14,60,42,12,54,277,325,602,106,104,208
01/19/2023,107,214,321,60,81,139,0,0,0,0,0,0,22,13,35,19,9,28,158,262,420,61,81,140
01/20/2023,138,396,534,79,139,217,0,0,0,0,0,0,31,20,51,30,15,45,195,490,685,80,139,218
01/21/2023,114,348,462,51,138,187,0,0,0,0,0,0,27,25,52,24,21,45,164,435,599,52,138,188
01/22/2023,26,0,26,17,0,17,0,0,0,0,0,0,7,15,22,6,10,16,39,15,54,17,10,27
01/23/2023,150,0,150,88,0,88,0,0,0,0,0,0,30,10,40,27,9,36,211,15,226,89,9,98
01/24/2023,128,0,128,71,0,71,0,0,0,0,0,0,23,14,37,22,9,31,162,14,176,71,9,80
01/25/2023,239,4,243,109,1,110,0,0,0,0,0,0,27,23,50,27,18,45,303,29,332,110,19,129
01/26/2023,155,319,474,82,125,207,0,0,0,0,0,0,19,20,39,19,16,35,193,431,624,83,127,210
01/27/2023,138,254,392,69,85,153,0,0,0,0,0,0,20,8,28,19,8,27,175,288,463,70,85,154
01/28/2023,43,0,43,27,0,27,0,0,0,0,0,0,10,11,21,10,9,19,57,11,68,27,9,36
01/29/2023,39,0,39,26,0,26,0,0,0,0,0,0,8,8,16,8,6,14,51,8,59,26,6,32
01/30/2023,123,0,123,65,0,65,0,0,0,0,0,0,23,14,37,21,10,31,167,14,181,65,10,74
01/31/2023,137,0,137,79,0,79,0,0,0,0,0,0,31,18,49,28,13,41,183,18,201,79,13,92
02/01/2023,123,0,123,65,0,65,0,0,0,0,0,0,22,10,32,22,9,31,169,10,179,65,9,74
02/02/2023,114,0,114,66,0,66,0,0,0,0,0,0,19,9,28,17,7,24,148,9,157,67,7,74
02/03/2023,151,0,151,67,0,67,0,0,0,0,0,0,27,6,33,23,6,29,221,6,227,67,6,73
02/04/2023,61,2,63,24,1,25,0,0,0,0,0,0,10,7,17,7,7,14,78,10,88,24,8,32
02/05/2023,44,148,192,22,53,75,0,0,0,0,0,0,7,12,19,7,6,13,53,194,247,22,53,75
02/06/2023,117,0,117,58,0,58,0,0,0,0,0,0,23,9,32,20,9,29,166,9,175,58,9,67
02/07/2023,209,0,209,103,0,103,0,0,0,0,0,0,36,27,63,33,20,53,281,27,308,105,20,125
02/08/2023,135,0,135,64,0,64,0,0,0,0,0,0,18,13,31,18,11,29,174,13,187,65,11,76
02/09/2023,108,0,108,62,0,62,0,0,0,0,0,0,21,12,33,21,10,31,144,12,156,62,10,72
02/10/2023,219,0,219,131,0,131,0,0,0,0,0,0,49,13,62,44,12,56,295,13,308,134,12,146
02/11/2023,42,190,232,24,61,85,0,0,0,0,0,0,9,4,13,9,4,13,56,233,289,25,61,86
02/12/2023,28,0,28,15,0,15,0,0,0,0,0,0,8,1,9,7,1,8,41,1,42,15,1,16
02/13/2023,95,183,278,59,65,121,0,0,0,0,0,0,26,7,33,24,6,30,132,226,358,62,65,124
02/14/2023,237,0,237,159,0,159,0,0,0,0,0,0,36,12,48,35,12,46,310,12,322,160,12,171
02/15/2023,153,339,492,87,103,190,0,0,0,0,0,0,25,5,30,24,5,29,196,385,581,88,104,192
02/16/2023,317,5,322,219,2,221,0,0,0,0,0,0,45,41,86,43,31,74,400,48,448,220,33,252
02/17/2023,199,444,643,116,166,282,0,0,0,0,0,0,28,17,45,26,13,39,251,519,770,117,166,283
02/18/2023,44,293,337,33,75,108,0,0,0,0,0,0,10,7,17,9,6,15,65,352,417,34,75,109
02/19/2023,64,319,383,38,125,163,0,0,0,0,0,0,12,12,24,11,11,22,86,381,467,39,125,164
02/20/2023,99,0,99,65,0,65,0,0,0,0,0,0,13,6,19,11,5,16,128,6,134,66,5,71
02/21/2023,54,0,54,40,0,40,0,0,0,0,0,0,16,12,28,15,9,24,83,12,95,42,9,50
02/22/2023,147,2,149,90,1,91,0,0,0,0,0,0,30,13,43,27,12,39,206,16,222,91,13,104
02/23/2023,129,2,131,71,1,72,0,0,0,0,0,0,18,13,31,18,12,30,168,17,185,72,13,85
02/24/2023,102,226,328,62,73,134,0,0,0,0,0,0,24,16,40,21,11,32,156,282,438,64,73,136
02/25/2023,58,0,58,38,0,38,0,0,0,0,0,0,10,13,23,10,9,19,75,13,88,39,9,48
02/26/2023,39,0,39,26,0,26,0,0,0,0,0,0,12,11,23,11,8,19,57,11,68,27,8,35
02/27/2023,140,0,140,89,0,89,0,0,0,0,0,0,26,20,46,24,16,40,185,20,205,89,16,105
02/28/2023,130,0,130,63,0,63,0,0,0,0,0,0,21,10,31,20,9,29,176,10,186,65,9,74
03/01/2023,113,2,115,56,1,57,0,0,0,0,0,0,19,10,29,18,7,25,146,13,159,56,8,64
03/02/2023,90,0,90,63,0,63,0,0,0,0,0,0,25,12,37,22,10,32,126,12,138,64,10,74
03/03/2023,126,407,533,71,113,182,0,0,0,0,0,0,33,13,46,29,12,41,175,483,658,72,113,183
03/04/2023,38,2,40,24,1,25,0,0,0,0,0,0,8,5,13,8,5,13,54,8,62,24,6,30
03/05/2023,38,2,40,19,1,20,0,0,0,0,0,0,5,8,13,5,6,11,45,11,56,19,7,26
03/06/2023,102,292,394,59,104,163,0,0,0,0,0,0,18,13,31,17,12,29,140,352,492,60,104,164
03/07/2023,113,288,401,81,89,167,0,0,0,0,0,0,27,13,40,26,9,35,164,367,531,82,89,168
03/08/2023,175,571,746,107,177,282,0,0,0,0,0,0,40,42,82,39,34,73,255,674,929,107,178,283
03/09/2023,252,0,252,144,0,144,0,0,0,0,0,0,61,23,84,57,20,77,372,23,395,145,20,164
03/10/2023,200,0,200,114,0,114,0,0,0,0,0,0,45,29,74,40,24,64,292,29,321,115,24,139
03/11/2023,36,224,260,27,80,107,0,0,0,0,0,0,10,17,27,9,16,25,49,274,323,27,80,107
03/12/2023,36,0,36,25,0,25,0,0,0,0,0,0,9,12,21,8,10,18,53,12,65,25,10,35
03/13/2023,106,253,359,66,77,142,0,0,0,0,0,0,26,8,34,23,8,31,156,306,462,66,77,142
03/14/2023,314,764,1078,190,265,451,0,0,0,0,0,0,58,52,110,50,39,89,424,961,1385,190,266,452
03/15/2023,449,1340,1789,259,405,657,0,0,0,0,0,0,88,45,133,79,41,120,627,1567,2194,260,406,659
03/16/2023,201,523,724,117,152,266,0,0,0,0,0,0,43,25,68,39,23,62,289,618,907,118,152,267
03/17/2023,180,454,634,103,146,246,0,0,0,0,0,0,27,22,49,26,19,45,243,532,775,103,147,247
03/18/2023,67,0,67,37,0,37,0,0,0,0,0,0,14,16,30,12,14,26,94,16,110,37,14,51
03/19/2023,30,0,30,17,0,17,0,0,0,0,0,0,6,7,13,5,6,11,44,7,51,17,6,22
03/20/2023,134,0,134,89,0,89,0,0,0,0,0,0,37,11,48,34,11,45,207,11,218,89,11,100
03/21/2023,139,0,139,71,0,71,0,0,0,0,0,0,26,13,39,25,13,38,185,13,198,73,13,86
03/22/2023,132,316,448,62,92,153,0,0,0,0,0,0,26,11,37,24,8,32,174,388,562,63,92,154
03/23/2023,220,395,615,130,137,265,0,0,0,0,0,0,36,17,53,34,15,49,300,458,758,130,137,265
03/24/2023,148,362,510,86,121,206,0,0,0,0,0,0,35,18,53,30,16,46,216,427,643,86,121,206
03/25/2023,94,2,96,56,1,57,0,0,0,0,0,0,24,8,32,23,7,30,137,11,148,56,8,64
03/26/2023,54,0,54,36,0,36,0,0,0,0,0,0,9,5,14,9,5,14,74,5,79,36,5,41
03/27/2023,208,0,208,117,0,117,0,0,0,0,0,0,44,10,54,40,10,50,293,10,303,118,10,128
03/28/2023,162,414,576,88,125,212,0,0,0,0,0,0,27,19,46,26,14,40,218,502,720,88,125,212
03/29/2023,209,430,639,113,121,231,0,0,0,0,0,0,33,13,46,28,9,37,289,505,794,113,121,231
03/30/2023,218,345,563,104,112,207,0,0,0,0,0,0,32,8,40,27,8,35,294,394,688,105,112,208
03/31/2023,314,1138,1452,190,310,494,0,0,0,0,0,0,91,56,147,81,44,125,450,1314,1764,190,310,494
04/01/2023,81,299,380,50,91,138,0,0,0,0,0,0,12,10,22,11,8,19,108,344,452,50,91,138
04/02/2023,38,0,38,26,0,26,0,0,0,0,0,0,10,13,23,9,11,20,54,13,67,26,11,37
04/03/2023,278,0,278,145,0,145,0,0,0,0,0,0,50,16,66,40,15,55,370,16,386,145,15,160
04/04/2023,138,336,474,81,110,190,0,0,0,0,0,0,30,16,46,26,15,41,192,401,593,81,110,190
04/05/2023,123,275,398,69,94,161,0,0,0,0,0,0,21,9,30,19,6,25,168,318,486,69,94,161
04/06/2023,116,0,116,75,0,75,0,0,0,0,0,0,25,12,37,24,12,36,163,12,175,76,12,87
04/07/2023,78,0,78,51,0,51,0,0,0,0,0,0,28,25,53,25,23,47,116,25,141,52,23,74
04/08/2023,38,0,38,27,0,27,0,0,0,0,0,0,8,5,13,8,4,12,53,5,58,27,4,31
04/09/2023,29,0,29,17,0,17,0,0,0,0,0,0,8,7,15,8,5,13,40,7,47,17,5,22
04/10/2023,117,0,117,78,0,78,0,0,0,0,0,0,34,17,51,31,16,47,170,17,187,78,16,94
04/11/2023,162,0,162,95,0,95,0,0,0,0,0,0,38,22,60,33,17,50,236,22,258,97,17,114
04/12/2023,186,0,186,115,0,115,0,0,0,0,0,0,48,19,67,42,18,60,269,19,288,116,18,134
04/13/2023,162,0,162,104,0,104,0,0,0,0,0,0,35,18,53,30,15,45,237,18,255,105,15,120
04/14/2023,106,353,459,68,122,187,0,0,0,0,0,0,20,16,36,19,11,30,141,441,582,69,122,188
04/15/2023,37,239,276,30,85,114,0,0,0,0,0,0,12,16,28,10,9,19,57,307,364,31,86,116
04/16/2023,35,0,35,22,0,22,0,0,0,0,0,0,9,0,9,9,0,9,49,0,49,22,0,22
04/17/2023,467,3,470,301,1,302,0,0,0,0,0,0,74,28,102,70,22,92,630,32,662,302,23,325
04/18/2023,264,648,912,155,227,379,0,0,0,0,0,0,48,32,80,46,22,68,369,791,1160,155,227,379
04/19/2023,190,0,190,114,0,114,0,0,0,0,0,0,38,19,57,35,14,49,266,19,285,116,14,130
04/20/2023,155,0,155,90,0,90,0,0,0,0,0,0,21,19,40,21,17,38,203,19,222,91,17,107
04/21/2023,95,214,309,54,64,118,0,0,0,0,0,0,11,10,21,10,9,19,128,256,384,54,64,118
04/22/2023,41,0,41,23,0,23,0,0,0,0,0,0,7,4,11,7,3,10,57,4,61,23,3,26
04/23/2023,56,0,56,32,0,32,0,0,0,0,0,0,9,9,18,8,7,15,86,9,95,32,7,39
04/24/2023,121,0,121,72,0,72,0,0,0,0,0,0,18,18,36,17,14,31,176,18,194,72,14,86
04/25/2023,252,0,252,159,0,159,0,0,0,0,0,0,62,28,90,59,24,83,363,28,391,159,24,183
04/26/2023,262,2,264,144,1,145,0,0,0,0,0,0,47,26,73,44,24,68,362,29,391,144,25,169
04/27/2023,170,0,170,87,0,87,0,0,0,0,0,0,38,26,64,30,22,52,240,26,266,87,22,109
04/28/2023,113,0,113,70,0,70,0,0,0,0,0,0,20,17,37,19,12,31,146,17,163,71,12,83
04/29/2023,42,0,42,32,0,32,0,0,0,0,0,0,6,4,10,6,4,10,56,4,60,32,4,36
04/30/2023,44,134,178,23,43,65,0,0,0,0,0,0,6,8,14,4,7,11,61,157,218,23,43,65
05/01/2023,52,0,52,34,0,34,0,0,0,0,0,0,13,5,18,12,4,16,76,5,81,34,4,38
05/02/2023,89,254,343,58,81,139,0,0,0,0,0,0,22,15,37,19,12,31,133,302,435,60,81,141
05/03/2023,157,445,602,99,141,239,0,0,0,0,0,0,43,23,66,40,21,60,219,528,747,99,141,239
05/04/2023,165,371,536,108,143,251,0,0,0,0,0,0,26,22,48,25,18,43,212,453,665,108,143,251
05/05/2023,205,330,535,128,111,239,0,0,0,0,0,0,31,13,44,27,13,40,270,379,649,128,111,239
05/06/2023,52,138,190,25,52,77,0,0,0,0,0,0,8,3,11,8,3,11,66,164,230,26,52,78
05/07/2023,35,124,159,14,39,53,0,0,0,0,0,0,9,7,16,9,6,15,57,143,200,14,39,53
05/08/2023,118,288,406,78,87,162,0,0,0,0,0,0,23,14,37,23,10,33,166,343,509,79,87,163
05/09/2023,137,257,394,86,89,173,0,0,0,0,0,0,28,13,41,27,13,40,198,304,502,87,90,175
05/10/2023,402,916,1318,252,360,608,0,0,0,0,0,0,80,40,120,75,34,109,516,1068,1584,252,360,608
05/11/2023,152,384,536,90,140,229,0,0,0,0,0,0,27,23,50,25,20,45,207,456,663,90,140,229
05/12/2023,308,1205,1513,212,405,613,0,0,0,0,0,0,75,52,127,72,43,115,426,1425,1851,213,405,613
05/13/2023,76,455,531,47,119,163,0,0,0,0,0,0,9,9,18,9,9,18,94,529,623,47,119,163
05/14/2023,42,238,280,26,72,98,0,0,0,0,0,0,8,10,18,8,7,15,56,302,358,26,72,98
05/15/2023,118,0,118,64,0,64,0,0,0,0,0,0,27,16,43,26,12,38,155,16,171,64,12,76
05/16/2023,164,0,164,92,0,92,0,0,0,0,0,0,38,52,90,37,41,78,240,52,292,92,41,133
05/17/2023,114,0,114,59,0,59,0,0,0,0,0,0,22,15,37,20,12,32,164,15,179,61,12,73
05/18/2023,130,262,392,64,79,142,0,0,0,0,0,0,20,12,32,19,10,29,166,317,483,64,79,142
05/19/2023,128,358,486,77,104,181,0,0,0,0,0,0,29,27,56,24,19,42,176,433,609,77,105,181
05/20/2023,20,0,20,14,0,14,0,0,0,0,0,0,5,21,26,5,13,18,28,21,49,14,13,27
05/21/2023,36,133,169,19,42,61,0,0,0,0,0,0,10,10,20,9,8,17,53,160,213,19,42,61
05/22/2023,140,0,140,84,0,84,0,0,0,0,0,0,28,10,38,26,10,36,185,10,195,84,10,94
05/23/2023,215,0,215,104,0,104,0,0,0,0,0,0,49,23,72,44,14,58,305,23,328,104,14,118
05/24/2023,157,604,761,80,177,252,0,0,0,0,0,0,31,34,65,26,30,56,228,747,975,80,178,253
05/25/2023,204,510,714,106,144,247,0,0,0,0,0,0,30,17,47,27,12,39,265,609,874,107,145,249
05/26/2023,169,364,533,69,95,164,0,0,0,0,0,0,27,22,49,24,16,40,224,429,653,70,95,165
05/27/2023,52,270,322,30,78,108,0,0,0,0,0,0,17,9,26,15,8,23,77,315,392,32,78,110
05/28/2023,36,200,236,23,65,88,0,0,0,0,0,0,9,16,25,9,15,24,51,245,296,23,65,88
05/29/2023,144,381,525,85,133,218,0,0,0,0,0,0,27,22,49,22,18,40,197,460,657,86,133,219
05/30/2023,146,414,560,71,112,181,0,0,0,0,0,0,30,11,41,29,10,39,203,474,677,71,113,182
05/31/2023,184,439,623,109,144,251,0,0,0,0,0,0,40,20,60,39,20,59,256,529,785,109,144,251
06/01/2023,151,360,511,88,115,198,0,0,0,0,0,0,31,20,51,27,16,42,207,439,646,88,115,198
06/02/2023,169,440,609,101,135,233,0,0,0,0,0,0,35,14,49,31,13,44,232,532,764,102,136,234
06/03/2023,48,262,310,26,66,90,0,0,0,0,0,0,11,5,16,11,3,14,68,296,364,26,66,90
06/04/2023,49,0,49,26,0,26,0,0,0,0,0,0,5,14,19,5,11,16,60,14,74,26,11,37
06/05/2023,125,323,448,76,110,185,0,0,0,0,0,0,29,8,37,28,7,35,171,372,543,76,110,185
06/06/2023,276,792,1068,145,230,374,0,0,0,0,0,0,75,34,109,66,28,94,406,930,1336,155,230,384
06/07/2023,121,390,511,79,114,192,0,0,0,0,0,0,30,10,40,27,9,36,176,445,621,81,114,194
06/08/2023,85,390,475,47,117,164,0,0,0,0,0,0,23,10,33,20,10,30,125,462,587,47,117,164
06/09/2023,88,443,531,57,132,186,0,0,0,0,0,0,19,13,32,17,12,29,128,522,650,57,132,186
06/10/2023,45,249,294,34,82,116,0,0,0,0,0,0,8,11,19,8,10,18,57,294,351,36,82,118
06/11/2023,37,183,220,21,63,83,0,0,0,0,0,0,8,12,20,8,9,17,56,226,282,21,63,83
06/12/2023,138,380,518,84,100,184,0,0,0,0,0,0,38,12,50,31,11,42,200,437,637,86,100,186
06/13/2023,198,356,554,109,132,241,0,0,0,0,0,0,36,14,50,33,10,43,268,428,696,111,132,243
06/14/2023,158,0,158,83,0,83,0,0,0,0,0,0,29,8,37,27,7,34,211,8,219,83,7,90
06/15/2023,173,339,512,102,118,219,0,0,0,0,0,0,34,10,44,27,9,36,239,394,633,102,118,219
06/16/2023,117,385,502,75,133,207,0,0,0,0,0,0,31,20,51,26,17,43,171,459,630,75,133,207
06/17/2023,52,217,269,29,67,96,0,0,0,0,0,0,14,13,27,12,10,22,77,271,348,30,67,97
06/18/2023,42,224,266,25,62,84,0,0,0,0,0,0,13,8,21,12,8,19,69,255,324,25,62,84
06/19/2023,211,0,211,105,0,105,0,0,0,0,0,0,51,6,57,46,5,51,292,6,298,106,5,111
06/20/2023,178,0,178,113,0,113,0,0,0,0,0,0,45,15,60,43,13,56,258,15,273,114,13,127
06/21/2023,152,396,548,84,100,182,0,0,0,0,0,0,32,17,49,28,16,44,235,457,692,84,100,182
06/22/2023,113,375,488,69,112,180,0,0,0,0,0,0,32,10,42,27,9,36,155,431,586,70,112,181
06/23/2023,136,0,136,72,0,72,0,0,0,0,0,0,26,13,39,25,11,36,191,13,204,72,11,83
06/24/2023,53,293,346,28,75,103,0,0,0,0,0,0,10,8,18,8,7,15,68,325,393,28,75,103
06/25/2023,37,120,157,21,44,64,0,0,0,0,0,0,8,5,13,7,4,11,59,140,199,21,44,64
06/26/2023,110,221,331,75,71,145,0,0,0,0,0,0,21,6,27,19,5,24,148,258,406,76,71,146
06/27/2023,153,387,540,82,123,202,0,0,0,0,0,0,48,12,60,44,12,56,236,439,675,83,123,203
06/28/2023,385,1130,1515,259,417,671,0,0,0,0,0,0,72,54,126,66,47,113,532,1312,1844,260,417,672
06/29/2023,707,2069,2776,471,824,1293,0,0,0,0,0,0,138,120,258,129,102,231,966,2446,3412,473,824,1295
06/30/2023,254,906,1160,168,260,419,0,0,0,0,0,0,55,37,92,49,31,79,359,1057,1416,168,261,420
07/01/2023,98,0,98,61,0,61,0,0,0,0,0,0,18,8,26,15,8,23,133,8,141,62,8,70
07/02/2023,88,356,444,62,138,197,0,0,0,0,0,0,25,10,35,24,8,32,133,414,547,63,138,198
07/03/2023,220,431,651,120,154,273,0,0,0,0,0,0,53,33,86,47,22,69,337,538,875,121,154,274
07/04/2023,196,385,581,126,125,248,0,0,0,0,0,0,45,19,64,40,14,54,287,452,739,127,125,249
07/05/2023,184,0,184,107,0,107,0,0,0,0,0,0,35,7,42,33,6,39,253,7,260,107,6,113
07/06/2023,139,372,511,86,114,200,0,0,0,0,0,0,31,9,40,25,7,32,198,423,621,88,114,202
07/07/2023,133,510,643,84,162,243,0,0,0,0,0,0,33,24,57,32,22,54,200,619,819,85,162,244
07/08/2023,70,435,505,53,178,230,0,0,0,0,0,0,10,41,51,10,33,43,95,548,643,55,178,231
07/09/2023,31,0,31,24,0,24,0,0,0,0,0,0,12,8,20,11,8,19,51,8,59,24,8,32
07/10/2023,275,554,829,155,188,340,0,0,0,0,0,0,72,41,113,68,35,103,407,677,1084,155,189,341
07/11/2023,259,649,908,149,191,338,0,0,0,0,0,0,71,49,120,64,30,94,387,765,1152,151,191,340
07/12/2023,157,0,157,108,0,108,0,0,0,0,0,0,34,3,37,31,3,34,208,3,211,108,3,111
07/13/2023,102,320,422,61,95,153,0,0,0,0,0,0,20,15,35,18,13,31,137,368,505,61,95,153
07/14/2023,124,0,124,75,0,75,0,0,0,0,0,0,23,0,23,22,0,22,174,0,174,75,0,75
07/15/2023,48,0,48,29,0,29,0,0,0,0,0,0,13,0,13,11,0,11,65,0,65,29,0,29
07/16/2023,32,0,32,22,0,22,0,0,0,0,0,0,11,0,11,10,0,10,45,0,45,22,0,22
07/17/2023,137,0,137,85,0,85,0,0,0,0,0,0,29,1,30,28,1,29,190,1,191,85,1,86
07/18/2023,155,0,155,88,0,88,0,0,0,0,0,0,34,4,38,32,2,34,210,4,214,88,2,90
07/19/2023,201,417,618,124,149,270,0,0,0,0,0,0,45,25,70,40,22,62,286,501,787,124,149,270
07/20/2023,129,317,446,69,95,164,0,0,0,0,0,0,33,11,44,28,10,38,185,374,559,70,95,165
07/21/2023,140,0,140,93,0,93,0,0,0,0,0,0,26,0,26,24,0,24,197,0,197,93,0,93
07/22/2023,52,241,293,29,81,110,0,0,0,0,0,0,20,11,31,17,10,27,85,288,373,29,81,110
07/23/2023,30,0,30,18,0,18,0,0,0,0,0,0,4,0,4,4,0,4,34,0,34,18,0,18
07/24/2023,111,316,427,68,101,167,0,0,0,0,0,0,27,10,37,24,9,33,168,358,526,68,101,167
07/25/2023,113,403,516,69,115,183,0,0,0,0,0,0,25,10,35,23,9,32,151,458,609,69,115,183
07/26/2023,153,379,532,86,132,216,0,0,0,0,0,0,35,25,60,33,17,50,213,453,666,86,133,217
07/27/2023,131,397,528,69,126,195,0,0,0,0,0,0,31,14,45,26,11,37,182,463,645,69,126,195
07/28/2023,87,267,354,63,80,143,0,0,0,0,0,0,26,12,38,25,11,36,129,307,436,63,80,143
07/29/2023,60,362,422,39,119,158,0,0,0,0,0,0,18,17,35,16,13,29,86,421,507,39,119,158
07/30/2023,40,247,287,26,78,104,0,0,0,0,0,0,10,11,21,9,10,19,53,301,354,26,78,104
07/31/2023,173,0,173,99,0,99,0,0,0,0,0,0,55,1,56,51,1,52,269,1,270,99,1,100
08/01/2023,119,375,494,76,124,200,0,0,0,0,0,0,29,15,44,26,12,38,161,433,594,77,124,201
08/02/2023,116,318,434,65,112,176,0,0,0,0,0,0,34,15,49,31,15,46,177,388,565,65,113,177
08/03/2023,128,0,128,70,0,70,0,0,0,0,0,0,35,2,37,30,1,31,186,2,188,70,1,71
08/04/2023,106,0,106,57,0,57,0,0,0,0,0,0,27,0,27,23,0,23,157,0,157,57,0,57
08/05/2023,42,256,298,25,67,92,0,0,0,0,0,0,12,12,24,12,11,23,62,304,366,25,67,92
08/06/2023,19,127,146,13,37,49,0,0,0,0,0,0,4,4,8,4,4,8,25,141,166,13,37,49
08/07/2023,73,210,283,46,78,123,0,0,0,0,0,0,18,16,34,16,14,30,106,259,365,47,78,124
08/08/2023,109,262,371,59,86,145,0,0,0,0,0,0,19,17,36,18,15,33,151,322,473,60,86,146
08/09/2023,140,362,502,79,116,194,0,0,0,0,0,0,43,31,74,41,23,64,223,442,665,80,116,195
08/10/2023,121,277,398,56,100,155,0,0,0,0,0,0,29,16,45,27,13,40,173,332,505,56,100,155
08/11/2023,145,442,587,78,139,215,0,0,0,0,0,0,43,27,70,41,22,63,208,540,748,78,140,216
08/12/2023,49,192,241,27,90,116,0,0,0,0,0,0,9,7,16,8,6,14,63,219,282,27,90,116
08/13/2023,66,228,294,30,59,89,0,0,0,0,0,0,12,8,20,10,6,16,87,271,358,30,59,89
08/14/2023,122,0,122,67,0,67,0,0,0,0,0,0,28,0,28,26,0,26,169,0,169,67,0,67
08/15/2023,80,280,360,53,106,157,0,0,0,0,0,0,10,14,24,10,13,23,100,308,408,53,106,157
08/16/2023,176,343,519,101,130,228,0,0,0,0,0,0,43,27,70,39,21,59,252,423,675,101,131,229
08/17/2023,131,340,471,81,115,196,0,0,0,0,0,0,32,30,62,31,26,57,198,417,615,82,115,197
08/18/2023,133,0,133,71,0,71,0,0,0,0,0,0,33,1,34,33,1,34,185,1,186,72,1,73
08/19/2023,47,188,235,23,64,86,0,0,0,0,0,0,5,5,10,5,5,10,62,220,282,23,64,86
08/20/2023,26,231,257,17,67,84,0,0,0,0,0,0,6,15,21,4,11,15,35,266,301,17,67,84
08/21/2023,139,0,139,82,0,82,0,0,0,0,0,0,27,0,27,26,0,26,191,0,191,84,0,84
08/22/2023,160,0,160,90,0,90,0,0,0,0,0,0,37,1,38,36,1,37,221,1,222,90,1,91
08/23/2023,175,0,175,103,0,103,0,0,0,0,0,0,30,0,30,29,0,29,234,0,234,106,0,106
08/24/2023,209,658,867,136,215,350,0,0,0,0,0,0,40,26,66,37,18,55,281,753,1034,137,215,351
08/25/2023,139,505,644,98,150,247,0,0,0,0,0,0,29,18,47,26,10,36,189,599,788,100,150,249
08/26/2023,51,348,399,36,107,143,0,0,0,0,0,0,14,11,25,13,8,21,67,398,465,36,107,143
08/27/2023,57,183,240,28,73,101,0,0,0,0,0,0,11,5,16,10,4,14,76,212,288,28,73,101
08/28/2023,163,367,530,92,138,229,0,0,0,0,0,0,38,10,48,34,9,43,233,406,639,93,138,230
08/29/2023,187,445,632,109,162,269,0,0,0,0,0,0,45,28,73,41,23,64,264,527,791,109,162,269
08/30/2023,137,293,430,87,109,196,0,0,0,0,0,0,28,12,40,27,7,34,194,342,536,87,109,196
08/31/2023,156,372,528,102,123,224,0,0,0,0,0,0,32,14,46,29,13,42,215,433,648,102,123,224
09/01/2023,101,242,343,55,97,152,0,0,0,0,0,0,19,17,36,19,16,35,134,288,422,56,97,153
09/02/2023,44,149,193,23,54,77,0,0,0,0,0,0,9,10,19,9,7,16,55,168,223,24,54,78
09/03/2023,20,185,205,14,48,61,0,0,0,0,0,0,4,5,9,4,5,9,27,217,244,15,48,62
09/04/2023,113,0,113,71,0,71,0,0,0,0,0,0,30,0,30,26,0,26,168,0,168,73,0,73
09/05/2023,139,275,414,79,85,163,0,0,0,0,0,0,29,13,42,27,12,39,193,315,508,79,85,163
09/06/2023,112,335,447,71,103,174,0,0,0,0,0,0,27,13,40,24,11,35,155,378,533,71,103,174
09/07/2023,48,171,219,32,53,82,0,0,0,0,0,0,12,4,16,11,4,15,62,193,255,32,53,82
09/08/2023,79,224,303,51,76,127,0,0,0,0,0,0,23,11,34,20,10,30,120,269,389,51,76,127
09/09/2023,39,0,39,22,0,22,0,0,0,0,0,0,7,0,7,7,0,7,49,0,49,22,0,22
09/10/2023,27,0,27,15,0,15,0,0,0,0,0,0,5,0,5,3,0,3,38,0,38,15,0,15
09/11/2023,150,306,456,86,84,169,0,0,0,0,0,0,33,8,41,32,8,40,210,345,555,86,84,169
09/12/2023,127,321,448,70,111,181,0,0,0,0,0,0,31,18,49,27,14,41,181,373,554,70,111,181
09/13/2023,108,187,295,56,63,119,0,0,0,0,0,0,21,13,34,19,9,28,157,223,380,56,63,119
09/14/2023,93,177,270,60,61,121,0,0,0,0,0,0,21,10,31,20,8,28,127,210,337,60,61,121
09/15/2023,104,0,104,59,0,59,0,0,0,0,0,0,15,0,15,15,0,15,134,0,134,59,0,59
09/16/2023,41,137,178,28,54,82,0,0,0,0,0,0,8,10,18,8,8,16,51,166,217,28,54,82
09/17/2023,36,85,121,20,36,56,0,0,0,0,0,0,9,4,13,9,4,13,45,98,143,20,36,56
09/18/2023,150,358,508,80,112,191,0,0,0,0,0,0,30,17,47,29,15,44,221,403,624,82,112,192
09/19/2023,141,400,541,95,122,216,0,0,0,0,0,0,31,25,56,29,19,48,191,468,659,96,123,218
09/20/2023,159,0,159,111,0,111,0,0,0,0,0,0,36,1,37,34,1,35,230,1,231,111,1,112
09/21/2023,120,305,425,76,113,189,0,0,0,0,0,0,33,18,51,28,16,44,175,369,544,77,113,190
09/22/2023,88,0,88,54,0,54,0,0,0,0,0,0,25,1,26,23,1,24,124,1,125,55,1,56
09/23/2023,31,0,31,22,0,22,0,0,0,0,0,0,8,0,8,8,0,8,43,0,43,22,0,22
09/24/2023,24,109,133,17,38,55,0,0,0,0,0,0,5,2,7,5,2,7,33,126,159,17,38,55
09/25/2023,79,217,296,55,59,113,0,0,0,0,0,0,15,10,25,15,7,22,101,257,358,55,59,113
09/26/2023,88,334,422,55,84,138,0,0,0,0,0,0,19,19,38,16,15,31,118,381,499,55,84,138
09/27/2023,99,201,300,50,70,119,0,0,0,0,0,0,19,5,24,17,5,22,139,227,366,54,70,123
09/28/2023,150,274,424,73,96,168,0,0,0,0,0,0,27,9,36,26,8,34,208,314,522,74,96,169
09/29/2023,66,0,66,39,0,39,0,0,0,0,0,0,11,0,11,10,0,10,84,0,84,39,0,39
09/30/2023,130,616,746,85,193,276,0,0,0,0,0,0,22,29,51,21,24,45,179,723,902,85,193,276
10/01/2023,56,435,491,36,146,180,0,0,0,0,0,0,13,31,44,12,25,37,77,526,603,36,146,180
10/02/2023,179,533,712,114,178,291,0,0,0,0,0,0,34,33,67,34,27,61,229,635,864,115,178,292
10/03/2023,182,472,654,111,169,278,0,0,0,0,0,0,31,29,60,28,23,50,248,578,826,112,169,279
10/04/2023,151,408,559,92,138,229,0,0,0,0,0,0,34,17,51,31,16,47,222,492,714,93,139,231
10/05/2023,175,411,586,133,137,267,0,0,0,0,0,0,32,17,49,30,14,44,241,472,713,133,137,267
10/06/2023,105,300,405,64,90,154,0,0,0,0,0,0,22,11,33,20,10,30,148,327,475,65,90,155
10/07/2023,56,209,265,38,56,94,0,0,0,0,0,0,7,5,12,6,4,10,73,247,320,38,56,94
10/08/2023,36,147,183,23,57,80,0,0,0,0,0,0,7,14,21,6,12,18,45,182,227,24,57,81
10/09/2023,195,460,655,110,153,262,0,0,0,0,0,0,52,26,78,48,21,69,290,544,834,110,154,263
10/10/2023,144,432,576,83,123,202,0,0,0,0,0,0,24,21,45,23,19,42,194,503,697,84,123,203
10/11/2023,116,195,311,67,73,138,0,0,0,0,0,0,15,4,19,15,4,19,146,216,362,67,73,138
10/12/2023,43,184,227,27,52,78,0,0,0,0,0,0,12,9,21,11,6,17,62,220,282,27,52,78
10/13/2023,61,165,226,46,57,102,0,0,0,0,0,0,11,6,17,11,6,17,87,188,275,46,58,103
10/14/2023,54,212,266,39,72,111,0,0,0,0,0,0,11,6,17,11,6,17,80,232,312,40,72,112
10/15/2023,44,130,174,28,45,73,0,0,0,0,0,0,14,6,20,13,5,18,65,161,226,29,45,74
10/16/2023,166,339,505,106,139,245,0,0,0,0,0,0,39,17,56,33,16,49,229,402,631,106,139,245
10/17/2023,462,1383,1845,297,431,720,0,0,0,0,0,0,85,53,138,79,47,126,612,1594,2206,297,431,720
10/18/2023,323,852,1175,189,277,463,0,0,0,0,0,0,59,45,104,54,33,87,418,989,1407,189,277,463
10/19/2023,284,601,885,128,219,343,0,0,0,0,0,0,50,41,91,39,26,65,382,723,1105,128,219,343
10/20/2023,184,521,705,114,174,286,0,0,0,0,0,0,30,34,64,27,28,55,234,625,859,114,175,287
10/21/2023,80,401,481,54,137,191,0,0,0,0,0,0,14,14,28,13,12,25,103,452,555,54,137,191
10/22/2023,49,0,49,39,0,39,0,0,0,0,0,0,11,0,11,11,0,11,67,0,67,40,0,40
10/23/2023,184,0,184,114,0,114,0,0,0,0,0,0,41,2,43,40,2,42,251,2,253,115,2,117
10/24/2023,224,0,224,126,0,126,0,0,0,0,0,0,44,1,45,41,1,42,289,1,290,127,1,128
10/25/2023,287,0,287,147,0,147,0,0,0,0,0,0,40,1,41,35,1,36,370,1,371,149,1,150
10/26/2023,217,447,664,121,153,273,0,0,0,0,0,0,39,14,53,37,11,48,305,504,809,121,153,273
10/27/2023,151,452,603,91,151,241,0,0,0,0,0,0,33,10,43,33,9,42,210,505,715,91,151,241
10/28/2023,58,389,447,40,102,142,0,0,0,0,0,0,14,7,21,12,7,19,76,432,508,40,102,142
10/29/2023,60,258,318,41,83,123,0,0,0,0,0,0,11,10,21,11,10,21,77,293,370,41,83,123
10/30/2023,127,431,558,84,128,210,0,0,0,0,0,0,29,12,41,27,9,36,178,473,651,86,128,212
10/31/2023,153,387,540,87,131,217,0,0,0,0,0,0,33,18,51,29,17,46,222,452,674,89,131,219
11/01/2023,126,268,394,77,99,175,0,0,0,0,0,0,27,10,37,25,9,34,171,305,476,77,99,175
11/02/2023,56,254,310,36,67,103,0,0,0,0,0,0,13,9,22,11,9,20,75,285,360,36,67,103
11/03/2023,174,445,619,103,160,262,0,0,0,0,0,0,40,19,59,37,15,52,236,503,739,105,160,264
11/04/2023,61,235,296,37,85,122,0,0,0,0,0,0,13,16,29,13,11,24,87,278,365,37,85,122
11/05/2023,70,219,289,40,75,114,0,0,0,0,0,0,18,9,27,16,6,22,91,244,335,40,75,114
11/06/2023,186,419,605,120,141,258,0,0,0,0,0,0,42,26,68,41,14,55,247,495,742,121,141,259
11/07/2023,187,517,704,123,167,287,0,0,0,0,0,0,52,36,88,48,31,79,266,603,869,125,167,289
11/08/2023,144,383,527,90,135,222,0,0,0,0,0,0,31,27,58,31,24,55,187,452,639,91,135,223
11/09/2023,145,437,582,76,163,238,0,0,0,0,0,0,24,13,37,23,9,32,188,481,669,77,163,239
11/10/2023,130,314,444,80,110,190,0,0,0,0,0,0,26,9,35,26,8,34,182,351,533,81,110,191
11/11/2023,32,167,199,22,54,75,0,0,0,0,0,0,9,9,18,9,7,16,49,186,235,23,54,76
11/12/2023,40,181,221,25,70,94,0,0,0,0,0,0,13,11,24,12,9,20,65,212,277,26,71,96
11/13/2023,104,309,413,66,99,165,0,0,0,0,0,0,21,9,30,19,6,25,140,346,486,66,99,165
11/14/2023,151,336,487,88,116,203,0,0,0,0,0,0,48,14,62,45,14,59,232,404,636,89,116,204
11/15/2023,97,282,379,61,95,153,0,0,0,0,0,0,19,16,35,19,15,33,136,337,473,62,96,155
11/16/2023,201,431,632,100,124,222,0,0,0,0,0,0,33,15,48,32,14,46,267,494,761,104,124,226
11/17/2023,107,228,335,55,81,133,0,0,0,0,0,0,20,8,28,19,8,27,145,271,416,55,81,133
11/18/2023,57,267,324,39,80,119,0,0,0,0,0,0,10,8,18,9,8,17,72,302,374,39,80,119
11/19/2023,48,194,242,27,73,98,0,0,0,0,0,0,13,7,20,11,7,18,64,230,294,27,73,98
11/20/2023,111,227,338,70,105,172,0,0,0,0,0,0,24,15,39,24,12,36,149,251,400,70,105,172
11/21/2023,183,242,425,107,98,204,0,0,0,0,0,0,38,12,50,37,11,48,257,282,539,108,98,205
11/22/2023,141,329,470,75,114,188,0,0,0,0,0,0,31,29,60,27,20,47,187,408,595,75,114,188
11/23/2023,175,368,543,99,116,212,0,0,0,0,0,0,22,8,30,20,6,26,235,411,646,99,116,212
11/24/2023,122,409,531,75,139,210,0,0,0,0,0,0,28,14,42,27,12,39,168,469,637,75,139,210
11/25/2023,48,208,256,35,76,111,0,0,0,0,0,0,8,9,17,8,8,16,64,236,300,35,76,111
11/26/2023,22,174,196,15,55,70,0,0,0,0,0,0,6,8,14,5,8,13,32,195,227,15,55,70
11/27/2023,121,242,363,65,75,140,0,0,0,0,0,0,23,6,29,21,5,26,174,270,444,66,75,141
11/28/2023,132,362,494,70,112,181,0,0,0,0,0,0,27,13,40,24,12,36,188,398,586,70,113,182
11/29/2023,103,230,333,64,75,139,0,0,0,0,0,0,26,8,34,26,8,34,153,264,417,65,75,140
11/30/2023,210,426,636,93,147,240,0,0,0,0,0,0,35,19,54,32,18,50,271,491,762,93,147,240
12/01/2023,183,303,486,75,115,188,0,0,0,0,0,0,34,15,49,30,14,43,245,365,610,76,115,189
12/02/2023,46,236,282,22,80,102,0,0,0,0,0,0,11,10,21,9,9,18,65,273,338,22,80,102
12/03/2023,42,204,246,25,68,93,0,0,0,0,0,0,6,12,18,6,10,16,57,234,291,25,68,93
12/04/2023,126,350,476,77,99,175,0,0,0,0,0,0,30,11,41,29,9,38,176,375,551,77,99,175
12/05/2023,166,219,385,95,84,178,0,0,0,0,0,0,43,12,55,37,10,47,241,246,487,96,84,179
12/06/2023,20,51,71,11,22,33,0,0,0,0,0,0,4,7,11,4,6,10,27,68,95,11,22,33
12/07/2023,133,172,305,66,74,140,0,0,0,0,0,0,27,8,35,26,8,34,192,193,385,68,74,142
12/08/2023,127,280,407,54,81,135,0,0,0,0,0,0,17,21,38,15,16,31,168,346,514,55,81,136
12/09/2023,37,160,197,20,54,74,0,0,0,0,0,0,5,8,13,5,7,12,51,188,239,20,54,74
12/10/2023,40,91,131,21,39,60,0,0,0,0,0,0,10,8,18,8,5,13,59,105,164,21,39,60
12/11/2023,214,280,494,103,100,200,0,0,0,0,0,0,41,25,66,38,22,60,302,343,645,106,104,207
12/12/2023,349,1236,1585,212,464,673,0,0,0,0,0,0,83,70,153,75,61,136,510,1438,1948,213,468,678
12/13/2023,265,556,821,122,195,315,0,0,0,0,0,0,45,32,77,41,26,67,362,652,1014,123,197,318
12/14/2023,235,382,617,114,147,258,0,0,0,0,0,0,54,30,84,48,19,67,327,454,781,114,148,259
12/15/2023,189,373,562,99,143,238,0,0,0,0,0,0,31,9,40,28,9,37,260,428,688,100,143,239
12/16/2023,74,326,400,44,127,168,0,0,0,0,0,0,20,11,31,17,9,26,112,372,484,44,127,168
12/17/2023,56,225,281,26,98,123,0,0,0,0,0,0,8,12,20,8,8,16,74,266,340,26,99,124
12/18/2023,258,469,727,140,158,294,0,0,0,0,0,0,48,17,65,46,16,62,367,537,904,140,158,294
12/19/2023,351,616,967,160,211,365,0,0,0,0,0,0,60,28,88,54,25,79,464,741,1205,162,212,368
12/20/2023,174,449,623,92,173,263,0,0,0,0,0,0,40,17,57,35,14,49,239,525,764,92,173,263
12/21/2023,213,476,689,139,189,328,0,0,0,0,0,0,45,13,58,43,12,55,290,546,836,139,189,328
12/22/2023,132,332,464,90,134,223,0,0,0,0,0,0,38,18,56,36,17,53,192,389,581,91,134,224
12/23/2023,53,288,341,37,100,136,0,0,0,0,0,0,13,12,25,12,11,23,77,330,407,37,100,136
12/24/2023,43,239,282,29,92,121,0,0,0,0,0,0,11,7,18,10,7,17,59,277,336,29,92,121
12/25/2023,41,260,301,23,97,120,0,0,0,0,0,0,10,13,23,8,12,20,58,313,371,23,97,120
12/26/2023,141,344,485,68,135,201,0,0,0,0,0,0,23,20,43,21,18,39,199,392,591,69,135,202
12/27/2023,150,415,565,85,147,229,0,0,0,0,0,0,39,13,52,35,11,46,216,462,678,86,147,230
12/28/2023,168,423,591,100,165,264,0,0,0,0,0,0,38,17,55,32,14,46,236,472,708,100,165,264
12/29/2023,113,227,340,57,92,148,0,0,0,0,0,0,21,12,33,19,10,29,150,259,409,58,92,149
12/30/2023,38,145,183,23,62,85,0,0,0,0,0,0,6,8,14,6,6,12,54,160,214,23,62,85
12/31/2023,27,105,132,18,40,58,0,0,0,0,0,0,9,4,13,8,3,11,44,116,160,19,40,59
01/01/2024,33,139,172,19,43,61,0,0,0,0,0,0,3,1,4,3,1,4,43,150,193,19,43,61
01/02/2024,80,213,293,56,75,130,0,0,0,0,0,0,19,11,30,18,9,27,107,241,348,58,75,132
01/03/2024,156,335,491,80,128,208,0,0,0,0,0,0,35,22,57,28,19,47,229,403,632,81,128,209
01/04/2024,199,409,608,99,133,230,0,0,0,0,0,0,44,19,63,39,16,55,271,477,748,99,133,230
01/05/2024,230,495,725,110,178,283,0,0,0,0,0,0,38,38,76,37,26,63,302,611,913,111,178,284
01/06/2024,73,320,393,42,86,127,0,0,0,0,0,0,14,6,20,12,5,17,93,344,437,42,86,127
01/07/2024,68,286,354,33,89,121,0,0,0,0,0,0,10,5,15,10,5,15,83,318,401,33,89,121
01/08/2024,210,327,537,104,98,200,0,0,0,0,0,0,34,21,55,32,15,47,275,386,661,104,99,201
01/09/2024,238,525,763,117,153,269,0,0,0,0,0,0,46,17,63,43,15,58,319,598,917,119,153,271
01/10/2024,242,726,968,133,226,354,0,0,0,0,0,0,52,26,78,44,23,67,327,826,1153,133,226,354
01/11/2024,354,928,1282,174,283,449,0,0,0,0,0,0,48,45,93,46,34,80,452,1062,1514,175,284,451
01/12/2024,313,738,1051,136,238,372,0,0,0,0,0,0,39,42,81,35,26,61,372,850,1222,136,238,372
01/13/2024,132,466,598,55,152,205,0,0,0,0,0,0,17,17,34,17,17,34,166,529,695,56,152,206
01/14/2024,90,281,371,49,90,137,0,0,0,0,0,0,11,14,25,11,8,19,110,315,425,49,90,137
01/15/2024,207,631,838,100,176,276,0,0,0,0,0,0,36,17,53,30,16,46,267,696,963,102,176,278
01/16/2024,525,898,1423,220,263,478,0,0,0,0,0,0,66,38,104,60,29,89,642,999,1641,220,264,479
01/17/2024,507,1234,1741,203,344,541,0,0,0,0,0,0,58,37,95,54,33,87,623,1360,1983,204,344,542
01/18/2024,385,908,1293,168,251,416,0,0,0,0,0,0,61,24,85,56,21,77,492,1004,1496,170,251,418
01/19/2024,267,642,909,134,209,342,0,0,0,0,0,0,43,31,74,41,23,64,352,727,1079,136,209,344
01/20/2024,96,391,487,42,122,163,0,0,0,0,0,0,13,17,30,13,12,25,121,432,553,42,122,163
01/21/2024,0,0,0,0,0,0,0,0,0,0,0,0,0,0,0,0,0,0,0,0,0,0,0,0
01/22/2024,385,668,1053,162,193,354,0,0,0,0,0,0,44,35,79,41,29,70,466,759,1225,165,193,357
01/23/2024,396,805,1201,178,231,406,0,0,0,0,0,0,63,44,107,59,29,88,514,922,1436,179,232,408
01/24/2024,470,1210,1680,238,364,598,0,0,0,0,0,0,79,45,124,72,39,111,604,1354,1958,239,365,600
01/25/2024,353,902,1255,172,306,476,0,0,0,0,0,0,58,52,110,54,38,92,456,1038,1494,174,306,478
01/26/2024,400,780,1180,163,218,380,0,0,0,0,0,0,58,26,84,49,23,72,496,864,1360,164,218,381
01/27/2024,130,411,541,62,130,191,0,0,0,0,0,0,28,12,40,23,12,35,191,451,642,62,130,191
01/28/2024,86,464,550,43,136,175,0,0,0,0,0,0,15,5,20,15,5,20,120,529,649,45,136,177
01/29/2024,429,762,1191,184,226,406,0,0,0,0,0,0,64,20,84,60,17,77,527,855,1382,184,226,406
01/30/2024,428,772,1200,199,234,425,0,0,0,0,0,0,50,37,87,46,26,72,504,878,1382,200,234,426
01/31/2024,496,1045,1541,224,299,517,0,0,0,0,0,0,80,37,117,72,30,101,622,1177,1799,224,299,517
02/01/2024,329,591,920,160,186,341,0,0,0,0,0,0,43,26,69,41,21,62,405,669,1074,160,186,341
02/02/2024,491,1036,1527,235,359,587,0,0,0,0,0,0,70,41,111,66,33,98,619,1161,1780,235,359,587
02/03/2024,177,697,874,89,214,302,0,0,0,0,0,0,21,36,57,20,28,48,214,796,1010,89,214,302
02/04/2024,116,403,519,53,135,186,0,0,0,0,0,0,22,16,38,19,12,31,146,464,610,53,135,186
02/05/2024,486,860,1346,225,243,458,0,0,0,0,0,0,65,18,83,62,14,76,607,941,1548,226,243,459
02/06/2024,287,872,1159,139,283,420,0,0,0,0,0,0,51,53,104,47,44,91,382,1028,1410,141,284,423
02/07/2024,372,701,1073,187,227,414,0,0,0,0,0,0,71,37,108,64,25,89,486,807,1293,188,227,415
02/08/2024,376,724,1100,177,228,402,0,0,0,0,0,0,58,33,91,55,31,86,495,819,1314,178,228,403
02/09/2024,319,566,885,152,201,350,0,0,0,0,0,0,54,24,78,49,20,69,406,636,1042,155,201,353
02/10/2024,124,258,382,54,96,149,0,0,0,0,0,0,15,6,21,13,5,18,155,281,436,54,96,149
02/11/2024,64,228,292,35,87,122,0,0,0,0,0,0,10,15,25,9,13,22,82,268,350,36,88,124
02/12/2024,125,349,474,74,107,178,0,0,0,0,0,0,24,12,36,22,10,32,170,408,578,74,107,178
02/13/2024,110,307,417,66,109,174,0,0,0,0,0,0,22,7,29,21,7,28,150,345,495,66,109,174
02/14/2024,275,592,867,137,179,314,0,0,0,0,0,0,42,47,89,37,27,64,352,715,1067,138,180,316
02/15/2024,321,691,1012,170,244,412,0,0,0,0,0,0,54,41,95,49,31,80,421,803,1224,170,244,412
02/16/2024,473,988,1461,238,332,566,0,0,0,0,0,0,79,56,135,71,43,114,650,1165,1815,239,332,567
02/17/2024,119,489,608,71,140,210,0,0,0,0,0,0,23,23,46,22,18,40,162,568,730,72,140,211
02/18/2024,126,345,471,51,114,164,0,0,0,0,0,0,17,11,28,17,11,28,156,382,538,52,114,165
02/19/2024,302,756,1058,162,231,389,0,0,0,0,0,0,51,35,86,45,26,71,390,869,1259,162,231,389
02/20/2024,436,944,1380,196,249,441,0,0,0,0,0,0,62,31,93,56,29,85,543,1045,1588,197,249,442
02/21/2024,502,983,1485,222,311,524,0,0,0,0,0,0,68,52,120,62,40,102,635,1144,1779,223,311,525
02/22/2024,369,995,1364,179,275,452,0,0,0,0,0,0,67,43,110,59,33,92,503,1143,1646,180,275,453
02/23/2024,262,697,959,139,199,336,0,0,0,0,0,0,51,15,66,49,15,64,349,758,1107,141,199,338
02/24/2024,120,444,564,56,145,200,0,0,0,0,0,0,19,26,45,17,21,38,152,527,679,56,145,200
02/25/2024,129,331,460,62,108,169,0,0,0,0,0,0,16,15,31,15,13,28,167,392,559,62,109,169
02/26/2024,369,588,957,182,184,362,0,0,0,0,0,0,55,31,86,51,21,72,451,672,1123,182,184,362
02/27/2024,414,836,1250,189,256,442,0,0,0,0,0,0,68,37,105,64,29,93,551,929,1480,190,256,443
02/28/2024,370,919,1289,195,301,490,0,0,0,0,0,0,63,74,137,60,48,108,490,1116,1606,196,301,491
02/29/2024,404,889,1293,210,252,461,0,0,0,0,0,0,64,36,100,59,32,91,522,993,1515,211,253,463
03/01/2024,338,1055,1393,152,273,421,0,0,0,0,0,0,42,36,78,40,29,69,420,1181,1601,152,273,421
03/02/2024,160,711,871,86,234,320,0,0,0,0,0,0,22,42,64,19,31,50,199,844,1043,86,234,320
03/03/2024,122,380,502,65,124,187,0,0,0,0,0,0,19,19,38,19,11,30,151,427,578,65,124,187
03/04/2024,425,829,1254,231,285,513,0,0,0,0,0,0,75,53,128,71,44,115,533,950,1483,231,285,513
03/05/2024,374,923,1297,177,273,450,0,0,0,0,0,0,57,80,137,52,69,121,459,1096,1555,177,273,450
03/06/2024,500,1081,1581,239,306,539,0,0,0,0,0,0,83,117,200,80,96,175,641,1309,1950,240,307,541
03/07/2024,376,866,1242,177,268,441,0,0,0,0,0,0,74,100,174,69,87,155,487,1081,1568,177,270,443
03/08/2024,242,832,1074,137,231,366,0,0,0,0,0,0,55,127,182,46,82,128,320,1046,1366,137,231,366
03/09/2024,109,423,532,59,146,204,0,0,0,0,0,0,25,41,66,24,38,62,158,502,660,60,146,205
03/10/2024,88,297,385,41,108,149,0,0,0,0,0,0,14,45,59,12,38,50,111,376,487,41,109,150
03/11/2024,319,488,807,166,172,336,0,0,0,0,0,0,62,73,135,57,54,111,422,608,1030,167,173,338
03/12/2024,426,697,1123,212,216,427,0,0,0,0,0,0,69,71,140,60,59,119,536,819,1355,212,216,427
03/13/2024,393,642,1035,213,252,461,0,0,0,0,0,0,85,99,184,73,82,154,514,798,1312,213,252,461
03/14/2024,515,1029,1544,285,370,651,0,0,0,0,0,0,96,161,257,93,126,219,665,1310,1975,285,370,651
03/15/2024,453,1199,1652,216,355,567,0,0,0,0,0,0,87,138,225,81,119,200,575,1426,2001,218,357,571
03/16/2024,140,432,572,73,138,209,0,0,0,0,0,0,32,59,91,29,47,76,181,552,733,73,138,209
03/17/2024,84,427,511,54,115,166,0,0,0,0,0,0,11,54,65,11,40,51,104,529,633,55,116,168
03/18/2024,334,683,1017,178,215,390,0,0,0,0,0,0,54,81,135,49,68,117,410,825,1235,178,215,390
03/19/2024,527,1057,1584,249,329,572,0,0,0,0,0,0,75,112,187,69,89,158,644,1257,1901,250,329,573
03/20/2024,374,757,1131,203,271,468,0,0,0,0,0,0,69,93,162,67,77,143,497,934,1431,203,271,468
03/21/2024,422,1101,1523,197,291,480,0,0,0,0,0,0,75,144,219,70,120,187,541,1345,1886,197,291,480
03/22/2024,281,917,1198,143,254,391,0,0,0,0,0,0,45,99,144,37,73,110,353,1094,1447,143,254,391
03/23/2024,183,447,630,71,146,214,0,0,0,0,0,0,31,44,75,28,37,65,232,529,761,71,146,214
03/24/2024,121,323,444,53,106,157,0,0,0,0,0,0,18,36,54,16,32,48,155,384,539,53,106,157
